            [13, 10, 10, 10, 10, 10, 10, 10, 10, 10, 10, 10, 2, 10, 10, 10, 10, 10, 10, 10, 10, 10, 10, 10, 14],
            [7, 3, 3, 3, 3, 3, 6, 3, 3, 3, 3, 3, 7, 3, 3, 3, 3, 3, 3, 6, 3, 3, 3, 3, 7],
            [7, 3,13 , 10, 14, 3, 13, 10, 10, 10, 14, 3, 7, 3, 13, 10, 10, 10, 14, 3, 13, 10, 14, 3, 7],
            [7, 4, 16, 10, 15, 3, 16, 10, 10, 10, 15, 3, 7, 3, 16, 10, 10, 10, 15, 3, 16, 10, 15, 4, 7],
            [7, 3, 3, 3, 3, 3, 3, 3, 3, 3, 3, 3, 3, 3, 3, 3, 3, 3, 3, 3, 3, 3, 3, 3, 7],
            [7, 3, 12, 10, 11, 3, 8, 3, 13, 10, 14, 3, 8, 3, 13, 10, 14, 3, 8, 3, 12, 10, 11, 3, 7],
            [7, 3, 3, 3, 3, 3, 7, 3, 16, 10, 15, 3, 7, 3, 16, 10, 15, 3, 7, 3, 3, 3, 3, 3, 7],
            [16, 10, 10, 10, 14, 3, 7, 3, 3, 3, 3, 3, 7, 3, 3, 3, 3, 3, 7, 3, 13, 10, 10, 10, 15],
            [0, 0, 0, 0, 7, 3, 7, 0, 12, 10, 10, 10, 1, 10, 10, 10, 11, 0, 7, 3, 7, 0, 0, 0, 0],
            [0, 0, 0, 0, 7, 3, 7, 0, 0, 0, 0, 0, 0, 0, 0, 0, 0, 0, 7, 3, 7, 0, 0, 0, 0],
            [10, 10, 10, 10, 15, 3, 9, 0, 13, 10, 10, 5, 5, 5, 10, 10, 14, 0, 9, 3, 16, 10, 10, 10, 10],
            [0, 0, 0, 0, 0, 3, 0, 0, 7, 0, 0, 0, 0, 0, 0, 0, 7, 0, 0, 3, 0, 0, 0, 0, 0],
            [10, 10, 10, 10, 14, 3, 8, 0, 7, 0, 0, 0, 0, 0, 0, 0, 7, 0, 8, 3, 13, 10, 10, 10, 10],
            [0, 0, 0, 0, 7, 3, 7, 0, 16, 10, 10, 10, 10, 10, 10, 10, 15, 0, 7, 3, 7, 0, 0, 0, 0],
            [0, 0, 0, 0, 7, 3, 7, 0, 0, 0, 0, 0, 0, 0, 0, 0, 0, 0, 7, 3, 7, 0, 0, 0, 0],
            [13, 10, 10, 10, 15, 3, 9, 0, 12, 10, 10, 10, 2, 10, 10, 10, 11, 0, 9, 3, 16, 10, 10, 10, 14],
            [7, 3, 3, 3, 3, 3, 3, 3, 3, 3, 3, 3, 7, 3, 3, 3, 3, 3, 3, 3, 3, 3, 3, 3, 7],
            [7, 3, 12, 10, 14, 3, 13, 10, 10, 10, 14, 3, 7, 3, 13, 10, 10, 10, 14, 3, 13, 10, 11, 3, 7],
            [7, 4, 3, 3, 7, 3, 16, 10, 10, 10, 15, 3, 9, 3, 16, 10, 10, 10, 15, 3, 7, 3, 3, 4, 7],
            [16, 10, 14, 3, 7, 3, 3, 3, 3, 3, 3, 3, 0, 3, 3, 3, 3, 3, 3, 3, 7, 3, 13, 10, 15],
            [13, 10, 15, 3, 9, 3, 8, 3, 12, 10, 10, 10, 2, 10, 10, 10, 11, 3, 8, 3, 9, 3, 16, 10, 14],
            [7, 3, 3, 3, 3, 3, 7, 3, 3, 3, 3, 3, 7, 3, 3, 3, 3, 3, 7, 3, 3, 3, 3, 3, 7],
            [7, 3, 12, 10, 10, 10, 1, 10, 10, 10, 11, 3, 9, 3, 12, 10, 10, 10, 1, 10, 10, 10, 11, 3, 7],
            [7, 3, 3, 3, 3, 3, 3, 3, 3, 3, 3, 3, 6, 3, 3, 3, 3, 3, 3, 3, 3, 3, 3, 3, 7],
            [16, 10, 10, 10, 10, 10, 10, 10, 10, 10, 10, 10, 10, 10, 10, 10, 10, 10, 10, 10, 10, 10, 10, 10, 15]